aand	and
abilites	abilities
abilitiy	ability
abilties	abilities
abiltities	abilities
abiltiy	ability
abilty	ability
abitlities	abilities
ablity	ability
abloished	abolished
abou	about
abouve	above
abroptly	abruptly
absense	absence
absoloute	absolute
absolutily	absolutely
absolutly	absolutely
absract	abstract
abvoe	above
accelerat	acceleration
acceptible	acceptable
accerate	accurate
accointablity	accountability
accomadate	accommodate
accompained	accompanied
accompaned	accompanied
accompish	accomplish
accompished	accomplished
accopany	accompany
accoridng	according
accountablity	accountability
accurarcy	accuracy
accustic	acoustic
achademic	academic
achinvement	achievement
achive	achieve
achivement	achievement
acidently	accidentally
acocunt	account
acomodate	accommodate
acomplished	accomplished
acquistion	acquisition
acsesory	accessory
actaul	actual
actaully	actually
actiities	activities
actino	action
activy	activity
acuaracy	accuracy
acutally	actually
adaptablity	adaptability
adavances	advances
additoinal	additional
addtion	addition
addtional	additional
aditional	additional
admisintarated	administrated
adn	and
adress	address
adresses	addresses
adressing	addressing
advantge	advantage
advatages	advantages
adventagous	advantageous
adversly	adversely
advtange	advantage
aestetics	aesthetics
afew	a few
affiars	affairs
aford	afford
afterall	after all
againsts	against
agaisnt	against
aganizing	agonizing
agianst	against
agreemnet	agreement
agressive	aggressive
agressors	aggressors
ahd	and
ahve	have
ahving	having
airpoirt	airport
ajusted	adjusted
allaberate	elaborate
alleinated	alienated
allians	aliens
allliance	alliance
allready	already
alomst	almost
alos	also
alot	a lot
alow	allow
alread	already
alredy	already
als	also
alteraive	alternative
alternativbe	alternative
alternativly	alternatively
altrustic	altruistic
alturnative	alternative
amazaing	amazing
amazied	amazed
ambigious	ambiguous
ambigous	ambiguous
ambigueties	ambiguities
ambiguos	ambiguous
ambiguty	ambiguity
ameircan	American
amerian	American
amigdula	amygdala
amke	make
amoung	among
ampiltude	amplitude
amplidute	amplitude
amplitiude	amplitude
anad	and
analaysis	analysis
analsyzed	analyzed
analyzied	analyzed
anaylsis	analysis
anchient	ancient
andthe	and the
angualr	angular
anicent	ancient
anicnet	ancient
anismals	animals
annd	and
annoiyed	annoyed
annouces	announces
anomolies	anomalies
anomoly	anomaly
anotehr	another
anouther	another
anscient	ancient
anser	answer
antartic	antarctic
anthing	anything
antinio	Antonio
antoher	another
anway	anyway
anxety	anxiety
anxisty	anxiety
anxitey	anxiety
anxity	anxiety
anyless	any less
anylisis	analysis
anythhing	anything
anywhre	anywhere
aobut	about
aparent	apparent
apear	appear
apears	appears
aplied	applied
appartment	apartment
appearence	appearance
appearent	apparent
apperance	appearance
apperatus	apparatus
apperent	apparent
appliad	applied
applicatoins	applications
appoligize	apologize
apprachiated	appreciated
apprachiete	appreciate
appreachate	appreciate
appreachated	appreciated
appreared	appeared
approch	approach
approches	approaches
approching	approaching
appropirate	appropriate
appropraite	appropriate
approprate	appropriate
appropration	appropriation
approriate	appropriate
approuch	approach
approximatly	approximately
aprasial	appraisal
april	April
aquaintance	acquaintance
aquire	acquire
aquired	acquired
aquiring	acquiring
aquisition	acquisition
archatype	archetype
architypes	archetypes
arcitecture	architecture
arestocracies	aristocracies
arethe	are the
arguement	argument
arguemtn	argument
arguemtns	arguments
arguemts	arguments
arguent	argument
aristotole	Aristotle
arithmatic	arithmetic
aritlce	article
arive	arrive
arivial	arrival
arriveal	arrival
arriveing	arriving
arround	around
artic	arctic
articulatied	articulated
artifical	artificial
artificioal	artificial
artilces	articles
artories	arteries
aruge	argue
aruged	argued
aruges	argues
arugment	argument
arugmetn	argument
arugmetns	arguments
arugues	argues
arugument	argument
arument	argument
askpects	aspects
aslo	also
asma	asthma
asperation	aspiration
asperations	aspirations
asscribed	ascribed
asselent	assailant
assesment	assessment
assigined	assigned
assocates	associates
assocation	association
assoiative	associative
assoicate	associate
assoicating	associating
assoicative	associative
assumpiton	assumption
assumtions	assumptions
assuptions	assumptions
astromony	astronomy
asumpition	assumption
asumptions	assumptions
asuume	assume
asymptotially	asymptotically
atend	attend
athor	author
athoritativly	authoritatively
athorities	authorities
athroty	authority
athte	at the
atmitting	admitting
atmostpher	atmosphere
atraction	attraction
attemptt	attempt
attendent	attendant
attmitted	admitted
atttempt	attempt
atvantage	advantage
audance	audience
audiance	audience
audiances	audiences
audtory	auditory
aurtories	arteries
authrity	authority
authroities	authorities
authroity	authority
authrotiy	authority
authroty	authority
authrty	authority
autobiograph	autobiography
autorhity	authority
autrority	authority
avaible	available
aveage	average
averge	average
avoidence	avoidance
axcident	accident
axiums	axioms
babling	babbling
backround	background
bairly	barley
bakcround	background
bandwith	bandwidth
baout	about
barly	barely
basicaly	basically
bassis	basis
batallion	battalion
bckround	background
beable	be able
beacuse	because
beatiful	beautiful
beatufiul	beautiful
beause	because
becaouse	because
becase	because
becasue	because
becouas	because
becuae	because
becuase	because
becuse	because
beggers	beggars
begginer	beginner
beggining	beginning
beging	beginning
begining	beginning
beginings	beginnings
begns	begins
behaviorsits	behaviorists
behavirosm	behaviorism
behavirsit	behaviorist
behavoirism	behaviorism
behavoristic	behavioristic
behavorists	behaviorists
behavour	behavior
behvirsit	behavioristic
beilve	believe
beilvieve	believe
beleifs	beliefs
beleive	believe
beleived	believed
belieiving	believing
belive	believe
belives	believes
beng	being
benieth	beneath
benifet	benefit
benith	beneath
betweem	between
betwen	between
betwoen	between
beuracrate	bureaucrat
beuracratic	bureaucratic
beurocratic	bureaucratic
beuruo	bureau
bewtween	between
beyound	beyond
bigtgest	biggest
biologcal	biological
biotany	botany
blelieved	believed
blugening	bludgeoning
blurrs	blurs
bourgeosise	bourgeoisie
brama	Brahma
brigning	bringing
brohter	brother
brotehr	brother
btoh	both
buisness	business
buld	build
bureacrary	bureaucracy
busness	business
bwasue	because
cacasion	Caucasian
calcuated	calculated
calcuatoin	calculation
calledthis	called this
calulate	calculate
cambrige	Cambridge
campains	campaigns
cann	can
cantalope	cantaloupe
caoptialism	capitalism
capernican	Copernican
capitalsim	capitalism
capitialism	capitalism
captial	capital
captialsm	capitalism
carfull	careful
carfully	carefully
catagerized	categorized
catagories	categories
catagory	category
cathelic	catholic
cathlic	catholic
cathlics	Catholics
catigorical	categorical
catigories	categories
catigorizations	categorizations
catigorizes	categorizes
catigory	category
cds	CDs
censorhip	censorship
centery	century
centrel	central
centruy	century
centry	century
cerimony	ceremony
cermunstances	circumstances
certaily	certainly
certanty	certainty
certiainty	certainty
certian	certain
certianly	certainly
challage	challenge
champtionship	championship
characterised	characterized
charatcteristics	characteristics
charaterizatoin	characterization
cheif	chief
chistanty	Christianity
chooseng	choosing
chrisitanty	Christianity
cieling	ceiling
cilestual	celestial
cinamon	cinnamon
circut	circuit
cirlce	circle
cirle	circle
cirrecular	curricular
cirriculium	curriculum
civilaiton	civilization
civilation	civilization
civilaztion	civilization
civization	civilization
civizations	civilizations
civlil	civil
claass	class
classfiy	classify
cleint	client
closly	closely
clumbsy	clumsy
cluture	culture
cna	can
cnat	can't
cnetury	century
cntry	century
coccaine	cocaine
cocerns	concerns
cognitve	cognitive
cogntive	cognitive
cohernet	coherent
colection	collection
colective	collective
collaberation	collaboration
collage	college
collaped	collapsed
collectivly	collectively
collectoin	collection
collor	color
comaprison	comparison
combinaion	combination
combinatoin	combination
comefrom	come from
comeing	coming
coment	comment
comesinto	comes into
comittee	committee
comjunity	community
commentray	commentary
comming	coming
comminity	community
commited	committed
committie	committee
committies	committees
commoly	commonly
commuism	communism
communalsm	communalism
communcains	communications
communcate	communicate
communcation	communication
communcations	communications
communcaton	communication
communiciton	communication
communictive	communicative
communilism	communalism
communisim	communism
communsist	communist
compair	compare
compaired	compared
compairing	comparing
comparied	compared
comparision	comparison
comparisioon	comparison
comparitive	comparative
comparitively	comparatively
compatence	competence
competance	competence
competative	competitive
competeing	competing
compisition	composition
compitance	competence
compitence	competence
completly	completely
complrete	complete
compltely	completely
compolsive	compulsive
componests	components
compostion	composition
comprehenstion	comprehension
comprehention	comprehension
compreshinsin	comprehension
compresihinsion	comprehension
comunicate	communicate
comunist	communist
comunity	community
conceptial	conceptual
concepual	conceptual
concervative	conservative
concieve	conceive
concious	conscious
conciously	consciously
conciousness	consciousness
conclulded	concluded
conclusiosn	conclusions
conclusisinvly	conclusively
conclution	conclusion
concomerate	conglomerate
concpet	concept
concpets	concepts
concreate	concrete
condiotn	condition
conditon	condition
conditons	conditions
condoitn	condition
condtion	condition
condtions	conditions
conectio	connection
conectoin	connection
conetxt	context
conficts	conflicts
confidnece	confidence
confluct	conflict
confomrity	conformity
confortable	comfortable
conisquenses	consequences
conitive	cognitive
conjusntion	conjunction
connction	connection
connecitons	connections
connnection	connection
conplete	complete
conrolls	controls
consiqently	consequently
consiquence	consequence
consiquences	consequences
consiquene	consequence
consiquenses	consequences
consiquiences	consequences
consise	concise
consiseness	conciseness
consistancy	consistency
consistant	consistent
consistning	consisting
consitancy	constancy
consitered	considered
constellaltion	constellation
constituants	constituents
constnat	constant
constorct	construct
constrainted	constrained
constraits	constraints
constrast	contrast
construcition	construction
constuction	construction
consturct	construct
consumming	consuming
contemproary	contemporary
conterversy	controversy
contimplates	contemplates
contimplating	contemplating
continueally	continually
continueing	continuing
continuim	continuum
continully	continually
continuted	continued
contiues	continues
contiune	continue
contiunes	continues
contridiction	contradiction
controll	control
contruct	construct
converation	conversation
conversative	conservative
convervative	conservative
convicing	convincing
coperating	cooperating
coperatoin	cooperation
corespoinding	corresponding
correctnes	correctness
correponded	corresponded
correspondene	correspondence
correspondes	correspondences
corricullum	curriculum
corrrect	correct
costums	costumes
coul	could
couldnt	couldn't
creatoin	creation
cridical	critical
critial	critical
criticial	critical
criticised	criticized
critiea	criteria
critisism	criticism
cronicals	chronicles
cronnical	chronicle
crystilize	crystallize
cuase	cause
cuased	caused
culmianting	culminating
cultrue	culture
culturlly	culturally
culure	culture
culutre	culture
culuture	culture
curriculm	curriculum
cutlure	culture
cuture	culture
cutures	cultures
cynisism	cynicism
darwianism	Darwinism
dayly	daily
debth	depth
december	December
decentrilized	decentralized
decieds	decides
decies	decides
decieve	deceive
decieved	deceived
decion	decision
decisons	decisions
decleration	declaration
decribe	describe
decsion	decision
deducitve	deductive
definiton	definition
defintion	definition
deleition	deletion
delievry	delivery
delivier	deliver
delux	deluxe
demcracy	democracy
demonstarted	demonstrated
demonstating	demonstrating
depeicted	depicted
dependtant	dependent
dependant	dependent
depreived	deprived
depresion	depression
derieved	derived
descbried	described
descibe	describe
descibes	describes
desciption	description
descrete	discrete
descrimate	discriminate
descrioptin	description
descrioptoin	description
descritpive	descriptive
descrpiton	description
desgined	designed
desperatly	desperately
despriatly	desperately
desribe	describe
destinctily	distinctly
destinctive	distinctive
destony	destiny
destory	destroy
deterimiantio	determination
deterine	determine
determanistic	deterministic
determies	determines
determinsm	determinism
detrmine	determine
devate	deviate
develoment	development
develompent	development
developetal	developmental
developmnet	development
developoment	development
devlop	develop
devloped	developed
devloping	developing
devlopment	development
diarrea	diarrhea
dicotomy	dichotomy
dicovers	discovers
didnt	didn't
dieing	dyeing
diference	difference
difernt	different
diffencences	differences
diffenernt	different
diffenrnt	different
diffent	different
diffently	differently
differenciate	differentiate
differentation	differentiation
differnce	difference
differnces	differences
differnece	difference
differneces	differences
differnently	differently
differnet	different
differnt	different
differntatled	differentiated
difficut	difficult
diffnice	difference
diffucilt	difficult
diffuclites	difficulties
diffucltueies	difficulties
difraction	diffraction
difractoin	diffraction
dilicately	delicately
dilivered	delivered
dilog	dialog
dimentional	dimensional
dimond	diamond
dirctors	directors
directoins	directions
dirivative	derivative
dirreclty	directly
dirrectly	directly
disadgvage	disadvantage
disapline	discipline
disaplines	disciplines
disapointment	disappointment
disatisfied	dissatisfied
discorse	discourse
discorvers	discovers
discorvy	discovery
discription	description
discrredits	discredits
discusscion	discussion
discussiong	discussing
discussus	discusses
disintrest	disinterest
disiple	disciple
dismis	dismiss
disoplies	disciples
disorentaion	disorientation
dispair	despair
disreagrd	disregard
dissappear	disappear
dissappoint	disappoint
distiction	distinction
distiguish	distinguish
distinc	distinct
distincly	distinctly
distingiueshed	distinguished
distingush	distinguish
distored	distorted
distorion	distortion
disucss	discuss
divise	devise
doenst	doesn't
doesnt	doesn't
doig	doing
dolfins	dolphins
domanance	dominance
dommination	domination
domniated	dominated
doucment	document
dresssed	dressed
eacdh	each
eachother	each other
eariler	earlier
easilty	easily
econimic	economic
econimical	economical
econmoic	economic
edocrine	endocrine
eduaciotn	education
eduaion	education
educatoin	education
educatoinal	educational
educatoins	educations
eductional	educational
effectivly	effectively
efffects	effects
efficany	efficacy
efficent	efficient
eitehr	either
elaberated	elaborated
elaped	elapsed
elavation	elevation
eleberate	elaborate
elegent	elegant
eleiquetnly	eloquently
elemetns	elements
eletist	elitist
eliete	elite
elietism	elitism
eliquant	eloquent
eliticst	elitist
emagine	imagine
embarass	embarrass
embriologiest	embryologist
embriology	embryology
emoitions	emotions
empericism	empiricism
empericists	empiricists
emperistist	empiricist
emperists	empiricists
emphisis	emphasis
empirecal	empirical
empireisist	empiricist
empiriscism	empiricism
empirisist	empiricist
encoperated	incorporated
encorperated	incorporated
encourging	encouraging
encoutner	encounter
endoctranated	indoctrinated
enherently	inherently
enland	England
enogh	enough
enoght	enough
enoht	enough
enormas	enormous
enought	enough
enspiring	inspiring
enterpratation	interpretation
enterpration	interpretation
enterpratitaion	interpretation
entertianent	entertainment
entirly	entirely
enviorment	environment
enviormental	environmental
enviornment	environment
enviornmental	environmental
enviornmentally	environmentally
envirnment	environment
epistomology	epistemology
equanted	acquainted
equatoin	equation
equiped	equipped
equivalant	equivalent
equla	equal
eritable	irritable
eroneous	erroneous
eror	error
errected	erected
errror	error
esape	escape
esentally	essentially
essance	essence
establishemnt	establishment
esteme	esteem
etiher	either
evalute	evaluate
eventaully	eventually
everthing	everything
everyting	everything
evidnece	evidence
evnets	events
evoltionary	evolutionary
evoluion	evolution
evoluiotn	evolution
evolutanry	evolutionary
evolutin	evolution
evolutioary	evolutionary
evolutoin	evolution
evolutuionary	evolutionary
evoutoinary	evolutionary
evvidence	evidence
exaclty	exactly
exadurated	exaggerated
exadurations	exaggerations
exagerate	exaggerate
exaguation	exaggeration
examinatoin	examination
examing	examining
examinle	examine
exampes	examples
exaple	example
exaples	examples
exaplles	examples
exapmple	example
exaturations	exaggerations
exausted	exhausted
excelence	excellence
excelent	excellent
excelet	excellent
excibit	exhibit
excpet	except
exectly	exactly
exemined	examined
exeriemtnal	experimental
exeriences	experiences
exerpeince	experience
exerpience	experience
exhange	exchange
exibits	exhibits
exicuting	executing
existaence	existence
existance	existence
existince	existence
existnece	existence
exlain	explain
exmained	examined
expain	explain
expaining	explaining
expalin	explain
expectionations	expectations
expectition	expectation
expereices	experience
expereince	experience
expereinced	experienced
experement	experiment
experice	experience
expericed	experienced
experiece	experience
experiecne	experience
experiement	experiment
experiemental	experimental
experiementally	experimentally
experiemtal	experimental
experiemtn	experiment
experiemtnal	experimental
experiemtns	experiments
experiene	experience
experient	experiment
experietns	experiments
experimenal	experimental
experimetal	experimental
experimetn	experiment
experimetnal	experimental
experimetner	experimenter
experimetns	experiments
experimnatal	experimental
experimtal	experimental
experince	experience
experinces	experiences
experinece	experience
experinemtal	experimental
experinmental	experimental
experirences	experiences
experitmental	experimental
explainatinos	explanations
explaitn	explain
explanaiton	explanation
explanitions	explanations
explian	explain
exploratoin	exploration
explorination	exploration
explotatoin	exploitation
expresion	expression
expresions	expressions
expresson	expression
expsure	exposure
exptertly	expertly
exraordinary	extraordinary
exsplained	explained
extened	extended
extensivly	extensively
extention	extension
exterial	external
extinciton	extinction
extratopin	extrapolation
facuilties	faculties
falure	failure
familiair	familiar
familier	familiar
fasinate	fascinate
fateaged	fatigued
february	February
Febuary	February
femaile	female
femanine	feminine
fequency	frequency
fertilzer	fertilizer
fictisuosh	fictitious
figue	figure
figuer	figure
figues	figures
figureing	figuring
finacyal	financial
finaly	finally
finnally	finally
finnaly	finally
fittend	fitted
fiugre	figure
flucuated	fluctuated
foerces	forces
fondation	foundation
fondations	foundations
forboding	foreboding
forclosure	foreclosure
forgien	foreign
foriegn	foreign
formatoin	formation
formeerly	formerly
forshadowed	foreshadowed
forthe	for the
fossile	fossil
fossle	fossil
foudn	found
foundatoin	foundation
fractio	fraction
fragil	fragile
framwork	framework
frctional	fictional
fredian	Freudian
frequences	frequencies
frequencey	frequency
frequetnly	frequently
freudan	Freudian
frictinal	frictional
frictoin	friction
friday	Friday
frmo	from
frustruation	frustration
funciton	function
functin	function
fundametnal	fundamental
fundementals	fundamentals
fundimental	fundamental
fundimentally	fundamentally
fundimetally	fundamentally
furhter	further
furnance	furnace
futher	further
futhur	further
ganddi	Gandhi
gandi	Gandhi
garantee	guarantee
gaunlet	gauntlet
geatest	greatest
generalasations	generalizations
generalizatoin	generalization
generaliztion	generalization
generaliztions	generalizations
generilized	generalized
generlize	generalize
generlly	generally
genetially	genetically
genious	genius
genral	general
genration	generation
genreal	general
genreally	generally
genreral	general
gentelmen	gentlemen
geometic	geometric
geometicraclly	geometrically
gestlat	gestalt
gestlt	gestalt
getinto	get into
gettnig	getting
giveing	giving
goverment	government
govermetn	government
governace	governance
govrnment	government
govt	government
gradualy	gradually
gramatical	grammatical
gramitical	grammatical
grammer	grammar
graveity	gravity
greatist	greatest
greeeks	greeks
greive	grieve
greivence	grievance
growthof	growth of
haadent	hadn't
hae	have
hahve	have
haivng	having
hampored	hampered
hankerchief	handkerchief
hapier	happier
happended	happened
happyness	happiness
hav	have
haveing	having
havent	haven't
havingn	having
havnet	haven't
havng	having
havve	have
hd	had
heighth	height
heristically	heuristically
hesitatoins	hesitations
hierachy	hierarchy
higest	highest
higlight	highlight
himsellf	himself
hinderence	hindrance
hipocrisy	hypocrisy
hippocraties	Hippocrates
histirical	historical
historcal	historical
histrical	historical
histroical	historical
histrorical	historical
histroy	history
hm	him
hmore	more
homogentity	homogeneity
hower	however
howerver	however
hsa	has
hsince	since
hstorical	historical
htat	that
hte	the
hteir	their
htem	them
hten	then
htey	they
hthat	that
htis	this
hunduism	Hinduism
huristic	heuristic
hury	hurry
hve	have
hving	having
hygene	hygiene
hypotetical	hypothetical
hypothalmus	hypothalamus
hypothese	hypotheses
hypothosis	hypothesis
I"ll	I'll
I"m	I'm
idd	did
identifcation	identification
identificatoin	identification
identiftion	identification
idividual	individual
idivual	individual
idnetify	identify
iintelligence	intelligence
ililegal	illegal
illigal	illegal
illimated	illuminate
illistrate	illustrate
illistrates	illustrates
illistrating	illustrating
illistration	illustration
illsusion	illusion
illumating	illuminating
ilteletucal	intellectual
ilumated	illuminated
imaes	images
imaginatoin	imagination
imagnative	imaginative
imbarisment	embarrassment
imbed	embed
imbrace	embrace
imedately	immediately
imediate	immediate
imediatly	immediately
immediatly	immediately
imorral	immoral
imparaitive	imperative
imparaitve	imperative
imparative	imperative
imparitive	imperative
impercise	imprecise
implicatoin	implication
implicelty	implicitly
implicetly	implicitly
imporant	important
importnace	importance
importnat	important
importnt	important
imposible	impossible
impossilbe	impossible
inablity	inability
inappropate	inappropriate
inapproprate	inappropriate
inapprorate	inappropriate
inapprorpate	inappropriate
incedentally	incidentally
incldud	included
inclduing	including
inclinatins	inclinations
incomeing	incoming
incomming	incoming
inconprehensible	incomprehensible
inconsistancies	inconsistencies
inconsistancy	inconsistency
incorperate	incorporate
incorperating	incorporating
incounter	encounter
incrase	increase
increadible	incredible
increaed	increased
increaseing	increasing
incremeted	incremented
Inda	India
indcluding	including
indcution	induction
indenpendece	independence
indentify	identify
indepedence	independence
indepednce	independence
independance	independence
independece	independence
independet	independent
independtely	independently
indepetndent	independent
inderect	indirect
inderstanding	understanding
indespensable	indispensable
indevors	endeavors
india	India
indias	India's
indiuval	individual
indiuvla	individual
indiuvuals	individuals
indivail	individual
indivduals	individuals
indivials	individuals
indiviual	individual
indiviuals	individuals
indiviudal	individual
indivual	individual
indivuals	individuals
indivualty	individuality
indivudal	individual
indivudality	individuality
indivudals	individuals
indivudual	individual
indivuduality	individuality
indivudually	individually
indivuduals	individuals
indivulas	individuals
indluding	including
indocritatned	indoctrinated
indpendent	independent
indtroductory	introductory
induldences	indulgences
industral	industrial
industural	industrial
induvaluals	individuals
induvuals	individuals
infenate	infinite
infinate	infinite
infinged	infringed
infinte	infinite
infinty	infinity
influced	influenced
influcend	influenced
influenctial	influential
influnce	influence
inforamtion	information
inforation	information
informatoin	information
informatoinal	informational
infrastrucutre	infrastructure
infultrate	infiltrate
ingrowsed	engrossed
inhance	enhance
inhanced	enhanced
inheartly	inherently
inherintly	inherently
inida	India
initailly	initially
inital	initial
initally	initially
initiavies	initiatives
inlightening	enlightening
inmy	in my
innferior	inferior
inperative	imperative
inperfect	imperfect
inplicatly	implicitly
inportant	important
inportnat	important
inquary	inquiry
insecrity	insecurity
insecurty	insecurity
insitution	institution
instalation	installation
instancew	instance
institions	institution
institiutions	institutions
instituions	institutions
instituiton	institution
instituitons	institutions
instituon	institution
instituons	institutions
instriments	instruments
instrumets	instruments
instutions	institutions
insufficent	insufficient
integratoin	integration
inteh	in the
intelectual	intellectual
intelectually	intellectually
intelectuals	intellectuals
intelecutal	intellectual
intelegence	intelligence
intelegent	intelligent
intelegnece	intelligence
intelengece	intelligence
intelengence	intelligence
intelitcaully	intellectually
intellignece	intelligence
intelligneces	intelligences
intenese	intense
intenetions	intentions
intensivly	intensively
intepretations	interpretations
intermision	intermission
internatization	internalization
interpersional	interpersonal
interpiration	interpretation
interpratation	interpretation
interpratioan	interpretation
interpration	interpretation
interpratoin	interpretation
interpreate	interpret
interpreating	interpreting
interpreation	interpretation
interpretaion	interpretation
interpretaoin	interpretation
interpretaoins	interpretations
interpretatio	interpretation
interpretatoin	interpretation
interprete	interpret
interpriation	interpretation
interpriatoin	interpretation
interprietaoin	interpretation
interpritaiton	interpretation
interpritation	interpretation
interpritatoin	interpretation
interpritaton	interpretation
interpriting	interpreting
interrpitaion	interpretation
intersing	interesting
intersitng	interesting
interst	interest
intersted	interested
intersting	interesting
interstng	interesting
interum	interim
intesne	intense
inthe	in the
intially	initially
intimatly	intimately
intonatoins	intonations
intregeing	intriguing
introvertive	introversive
intuitve	intuitive
investication	investigation
invetnion	invention
invomved	involved
invoved	involved
inwhich	in which
iqs	IQs
iresistible	irresistible
irrelavent	irrelevant
isolatoin	isolation
isoliation	isolation
isolition	isolation
issolated	isolated
itis	it is
itslef	itself
ivs	IVs
january	January
japanies	Japanese
jeporty	jeopardy
jewlery	jewelry
judgmetns	judgments
judment	judgment
jugment	judgment
july	July
june	June
justifiy	justify
justifiying	justifying
kaki	khaki
kenetic	kinetic
khz	kHz
kienetic	kinetic
kientic	kinetic
kinteic	kinetic
kknowledge	knowledge
knknowledge	knowledge
knkoldeg	knowledge
knkow	know
knoelge	knowledge
knoldege	knowledge
knoledge	knowledge
knolege	knowledge
knolwege	knowledge
knott	knot
knowdge	knowledge
knowedge	knowledge
knoweldge	knowledge
knoweledge	knowledge
knowelge	knowledge
knowldege	knowledge
knowldge	knowledge
knowlege	knowledge
knownledge	knowledge
knwlege	knowledge
kurn	kern
laberatory	laboratory
laboritiries	laboratories
laboritory	laboratory
labratory	laboratory
lalanguage	language
lanage	language
lanaguae	language
lanaguage	language
lanague	language
lanauge	language
lanaugue	language
langage	language
langague	language
langange	language
langauage	language
langaue	language
langaues	languages
langauge	language
langauges	languages
languae	language
langue	language
langueg	language
langugae	language
languge	language
langugue	language
lanuage	language
lanugauge	language
laugauge	language
launguage	language
laungue	language
learing	learning
learnig	learning
leavin	leaving
lecutre	lecture
lexial	lexical
libary	library
licence	license
lieterature	literature
limets	limits
limittaions	limitations
limmited	limited
limmiting	limiting
lingueistic	linguistic
lingugstic	linguistic
lingusitc	linguistic
lingusitic	linguistic
lingustic	linguistic
liniar	linear
liniarly	linearly
liniear	linear
linquesitdc	linguistic
lisense	license
listqugistic	linguistic
litererature	literature
litrature	literature
logicaly	logically
logicically	logically
lookedk	looked
looop	loop
lps	LPs
luckly	luckily
lunicy	lunacy
mabaye	maybe
mabey	maybe
maccho	macho
macintosh	Macintosh
maek	make
magnitism	magnetism
magntude	magnitude
maikng	making
maintian	maintain
manifistation	manifestation
mantainace	maintenance
mantiance	maintenance
manuver	maneuver
marvellous	marvelous
masicistic	masochistic
masss	mass
materals	materials
mathamatical	mathematical
mathmatical	mathematical
mathmatics	mathematics
mathmetical	mathematical
matress	mattress
matterial	material
maxium	maximum
maybey	maybe
mchu	much
mcuh	much
mearly	merely
measuing	measuring
measureing	measuring
measurment	measurement
measurments	measurements
mechancal	mechanical
medice	medicine
medicince	medicine
medivail	medieval
medivual	medieval
meetng	meeting
memoery	memory
memoize	memorize
memorizd	memorized
metaphores	metaphors
metaphrically	metaphorically
metephore	metaphor
metephores	metaphors
methedology	methodology
metiphore	metaphor
metiphorical	metaphorical
mgiht	might
mhz	MHz
mideral	medieval
mideval	medieval
midevial	medieval
midivial	medieval
mightly	mightily
milion	million
minipulated	manipulated
miniscule	minuscule
mintue	minute
mintues	minutes
mintute	minute
mirioring	mirroring
mispell	misspell
mmore	more
mnaintain	maintain
moday	Monday
modifed	modified
moevement	movement
molases	molasses
molicules	molecules
monalog	monologue
monday	Monday
monolog	monologue
monopalie	monopoly
monpoly	monopoly
moraity	morality
morgage	mortgage
moring	morning
morniing	morning
motehr	mother
motivzated	motivated
movemnet	movement
movemtn	movement
movenent	movement
movment	movement
movmnet	movement
mroe	more
mronign	morning
muhc	much
museam	museum
musicans	musicians
musieam	museum
muslum	Muslim
mysteriuos	mysterious
mystry	mystery
nad	and
nand	and
narative	narrative
nationlist	nationalist
natrual	natural
natual	natural
natuarlly	naturally
nautre	nature
nbetween	between
neccessity	necessity
neccestiy	necessity
neccisarily	necessarily
neccisarly	necessarily
neccisary	necessary
neccisity	necessity
neccissarly	necessarily
neccseitys	necessities
necesarily	necessarily
necesarly	necessarily
necesary	necessary
necessar	necessary
necicarly	necessarily
necicsarilly	necessarily
necisaarily	necessarily
necisarly	necessarily
necisary	necessary
necsiarly	necessarily
necsicarly	necessarily
negitive	negative
neice	niece
neitehr	neither
nervious	nervous
nesciarly	necessarily
nescisarliy	necessarily
nescisarly	necessarily
nesicarly	necessarily
nesicasrly	necessarily
nesicsarly	necessarily
nesisarly	necessarily
nessisarly	necessarily
nessisary	necessary
neumonia	pneumonia
neurol	neural
neuroscince	neuroscience
neursis	neurosis
newtionan	Newtonian
nexpercinetal	experimental
nofthe	of the
nomatter	no matter
nonviolance	nonviolence
normaly	normally
nothig	nothing
notto	not to
november	November
novermber	November
nubmers	numbers
numerious	numerous
nusance	nuisance
nutricion	nutrition
nver	never
nwith	with
obective	objective
oberves	observes
objectivly	objectively
obsereved	observed
observatoinal	observational
observatons	observations
obsesive	obsessive
obsevervation	observation
ocasion	occasion
occassionally	occasionally
occationaly	occasionally
occured	occurred
occurence	occurrence
occures	occurs
occuring	occurring
ocncept	concept
ocnintues	continues
ocomming	coming
october	October
oculd	could
ocur	occur
ofen	often
offfered	offered
officails	officials
offical	official
offically	officially
officals	officials
ofhte	of the
ofthe	of the
oftne	often
ofund	found
ojbecitve	objective
omerges	emerges
ommited	omitted
ommitted	omitted
oncomming	oncoming
onrigally	originally
ony	only
operatoins	operations
opion	opinion
oponent	opponent
oponets	opponents
oportunites	opportunities
oposite	opposite
oppisite	opposite
oppoinent	opponent
orcestrationg	orchestrating
oreven	or even
orginizaiton	organization
orginization	organization
orginizatoin	organization
orginizier	organizer
orgion	origin
origialnlly	originally
origianly	originally
origiated	originated
origion	origin
origional	original
origionally	originally
orignal	original
orrientation	orientation
orthe	or the
orthedoxy	orthodoxy
oscilation	oscillation
oscillatoins	oscillations
oservation	observation
ossialte	oscillate
ossilation	oscillation
ossilatiosn	oscillations
ossilatoins	oscillations
oteher	other
otehr	other
otehrs	others
otehrwise	otherwise
oten	often
othersie	otherwise
ourder	order
ourselvs	ourselves
overal	overall
overwelming	overwhelming
ovious	obvious
oviously	obviously
oviusly	obviously
owith	with
paradgms	paradigms
paradiems	paradigms
paradim	paradigm
paradimes	paradigms
paradimgs	paradigms
paralel	parallel
paralled	paralleled
parelell	parallel
parellel	parallel
parellels	parallels
paridigm	paradigm
paridim	paradigm
paritlces	particles
paritpants	participants
parliment	parliament
parrallel	parallel
parrelel	parallel
parrellel	parallel
partialy	partially
partically	particularly
particants	participants
particaptns	participants
particiants	participants
participaiton	participation
participats	participants
particpant	participant
particpants	participants
particpatns	participants
particualarly	particularly
particually	particularly
particualr	particular
particualrly	particularly
particualry	particularly
particuarlly	particularly
particuarly	particularly
particully	particularly
particupants	participants
partilces	particles
partipcant	participant
partipcants	participants
partiucalr	particular
partiucalrly	particularly
partiucarly	particularly
partiuclarly	particularly
partiular	particular
partucarly	particularly
passon	passion
peirod	period
penitrate	penetrate
peple	people
percention	perception
perceptial	perceptual
percetion	perception
percetipion	perception
percetipn	perception
percietipion	perception
percieve	perceive
percieved	perceived
percieving	perceiving
percise	precise
percisesly	precisely
percive	perceive
percived	perceived
percnet	percent
perfered	preferred
perficatly	perfectly
perfom	perform
perfomred	performed
perfonance	performance
performace	performance
performancies	performances
performcnae	performance
periodlical	periodical
perminant	permanent
perminantly	permanently
perminatly	permanently
perofrmance	performance
peronal	personal
peronality	personality
perpectives	perspectives
persistnat	persistent
personilty	personality
personlity	personality
perspecitve	perspective
perspecitves	perspectives
perspetive	perspective
perspetives	perspectives
phenedics	phonetics
phenomina	phenomena
philisophical	philosophical
philisphoical	philosophical
philolsophi	philosophy
philosohising	philosophizing
philosohper	philosopher
philosophizies	philosophizes
philosper	philosopher
philospher	philosopher
philosphers	philosophers
philosphi	philosophy
philosphic	philosophic
philosphical	philosophical
philosphies	philosophies
philosphized	philosophized
philosphy	philosophy
philospoher	philosopher
philospohy	philosophy
phinomina	phenomena
phoneotics	phonetics
phsically	physically
phsycological	psychological
phycis	physics
phycological	psychological
physcial	physical
physcology	psychology
physial	physical
pinciple	principle
placeing	placing
placisity	placidity
plannig	planning
plastisity	plasticity
platnet	planet
plausable	plausible
pliease	please
poele	people
poeple	people
poitn	point
polital	political
politcal	political
politcally	politically
politilcal	political
popualr	popular
populatoin	population
populitoins	populations
porgressing	progressing
porselain	porcelain
portible	portable
posible	possible
positoin	position
positve	positive
possesed	possessed
possibilties	possibilities
possibilty	possibility
possiblities	possibilities
possiblity	possibility
possition	position
possitions	positions
possitive	positive
possitoins	positions
possitve	positive
posssition	position
posstive	positive
posterrity	posterity
postive	positive
potatoe	potato
potentialy	potentially
potiental	potential
potnetial	potential
powr	power
practicies	practices
pradigm	paradigm
pradigms	paradigms
prduct	product
preception	perception
predicesors	predecessors
predictio	prediction
prefered	preferred
preformoed	preformed
premission	permission
prenatually	prenatally
preoccopation	preoccupation
prepariation	preparation
preparred	prepared
preperaoin	preparation
prequiste	prerequisite
preqursor	precursor
presentatoin	presentation
preseration	preservation
presetned	presented
presevered	persevered
preseves	preserves
presnet	present
presneted	presented
presuposed	presupposed
prevatiling	prevailing
prevous	previous
prgressing	progressing
priciple	principle
priciples	principles
primairly	primarily
primarly	primarily
princple	principle
prinple	principle
prisioner	prisoner
prisioners	prisoners
prisions	prisons
prisoniers	prisoners
privete	private
privladged	privileged
privleges	privileges
probabaly	probably
probabilties	probabilities
probabilty	probability
probabliity	probability
probablity	probability
probalbities	probabilities
probalbity	probability
probalbly	probably
probalby	probably
probaliby	probability
probelms	problems
probem	problem
problimatical	problematical
probly	probably
proccesing	processing
proccess	process
proccessed	processed
proccesses	processes
proccessing	processing
proceedures	procedures
proceessing	processing
processsig	processing
prodcution	production
prodcutive	productive
producitive	productive
producitve	productive
productoin	production
profesional	professional
profesor	professor
profet	profit
proffesional	professional
proffesor	professor
progrm	program
prolems	problems
proliferic	prolific
pronuciation	pronunciation
pronuncation	pronunciation
proparty	property
propigate	propagate
proportianal	proportional
protestiant	protestant
protistants	Protestants
provdie	provide
pschological	psychological
psycholgical	psychological
psycholgy	psychology
psycholigic	psychologic
psycholooical	psychological
psycolgical	psychological
psycolingustics	psycholinguistics
psycologic	psychologic
psycological	psychological
psycology	psychology
publicaion	publication
publically	publicly
puncuated	punctuated
pupose	purpose
puzel	puzzle
puzels	puzzles
puzzel	puzzle
pwoerful	powerful
pysical	physical
qiestion	question
qualificaion	qualification
qualificatoin	qualification
qualtiy	quality
quantitiave	quantitative
quesin	question
quesion	question
quesitons	questions
questio	question
questios	questions
questnios	questions
questoin	question
queston	question
questons	questions
quetion	question
quetioning	questioning
quetions	questions
quiestion	question
quiestioning	questioning
quilifies	qualifies
radiaclly	radically
ralndom	random
randomoly	randomly
rasberry	raspberry
rationlists	rationalists
reagard	regard
reagrd	regard
reajusted	readjusted
realated	related
realatoin	relation
realied	realized
realitive	relative
realitiy	reality
realiy	reality
realtion	relation
realtionship	relationship
realtively	relatively
realtivistic	relativistic
realzie	realize
reasorces	resources
recduction	reduction
receipant	recipient
recieve	receive
recieved	received
recived	received
recognation	recognition
recogniton	recognition
recognozable	recognizable
recogntion	recognition
recomend	recommend
reconize	recognize
rediculous	ridiculous
reductdion	reduction
redundencies	redundancies
reestablismetn	reestablishment
refective	reflective
refering	referring
refernce	reference
refledct	reflect
refletions	reflections
refrences	references
regualrly	regularly
rehabilitain	rehabilitation
relaitonships	relationships
relatihip	relationship
relationhip	relationship
relatioships	relationships
relativly	relatively
relavent	relevant
relevent	relevant
relgion	religion
relgious	religious
religoin	religion
religon	religion
religos	religious
religous	religious
reltionship	relationship
remaing	remaining
remarkabely	remarkably
remarkble	remarkable
rember	remember
remeber	remember
remeberng	remembering
rememberance	remembrance
renisosnse	renaissance
renissance	renaissance
reocrd	record
reomte	remote
reorginizing	reorganizing
repaeted	repeated
repalce	replace
repentence	repentance
repesent	represent
replaice	replace
repreesents	represents
represenative	representative
representaive	representative
represion	repression
represnents	represents
represson	repression
represssion	repression
represtaive	representative
represtn	represent
represtns	represents
reproccessing	reprocessing
reprodcue	reproduce
reputatoin	reputation
reqires	requires
requeres	requires
requierments	requirements
requirnment	requirement
requriment	requirement
reserach	research
reserch	research
resesarch	research
resistence	resistance
resitance	resistance
reslut	result
resocrd	record
resonsive	responsive
respectablity	respectability
respectivly	respectively
respoinded	responded
responsibilty	responsibility
responsibity	responsibility
responsiblities	responsibilities
responsiblity	responsibility
restiance	resistance
resulst	results
resutl	result
resutt	result
retoric	rhetoric
retrospecive	retrospective
retured	returned
reustl	result
revisting	revisiting
revlolution	revolution
revoltions	revolutions
revoluinary	revolutionary
revoluitons	revolutions
revolutin	revolution
revolutoin	revolution
revolutoins	revolutions
revoluton	revolution
revolutonary	revolutionary
revoution	revolution
rewritting	rewriting
ricahrd	Richard
rommeo	Romeo
rootd	rooted
rossivelt	Roosevelt
rotines	routines
rulars	rulers
rulling	ruling
rythm	rhythm
safty	safety
sanwich	sandwich
satified	satisfied
satifies	satisfies
saturday	Saturday
scandelus	scandalous
scaning	scanning
sceince	science
sceintific	scientific
sceintists	scientists
sceintsit	scientist
scenese	scenes
sceptical	skeptical
scepticism	skepticism
schedma	schema
schedual	schedule
schedualed	scheduled
schedualing	scheduling
schedul	schedule
schemada	schemata
scholoarship	scholarship
scholors	scholars
scieific	scientific
scieinfic	scientific
scieintifc	scientific
scieintific	scientific
scieintist	scientist
scieintists	scientists
scieintsits	scientists
scieintsts	scientists
scieitfic	scientific
scieitists	scientists
scieitns	scientists
scienc	science
sciencines	sciences
sciene	science
scienece	science
scienitifc	scientific
sciensts	scientists
scientif	scientific
scientifc	scientific
scinece	science
scinefitc	scientific
scinfitic	scientific
scinst	scientist
secondry	secondary
secratary	secretary
secrity	security
sectin	section
sectoin	section
seemilgly	seemingly
segmnet	segment
sendng	sending
senetces	sentence
sensatoin	sensation
senseory	sensory
sensroy	sensory
sensses	senses
sentances	sentences
sentecne	sentence
seperate	separate
seperated	separated
september	September
serach	search
seriosly	seriously
seroulsy	seriously
sesion	session
sesnes	senses
sesory	sensory
setings	settings
setitng	setting
setitngs	settings
seventeeth	seventeenth
severly	severely
sexaulity	sexuality
sexuallity	sexuality
shakerpear	Shakespeare
shakespear	Shakespeare
shakesperian	Shakespearean
shakspearian	Shakespearean
shaperoned	chaperoned
shoping	shopping
shoulld	should
siceince	science
siceintific	scientific
siceints	scientists
siceitifc	scientific
sicence	science
sicentist	scientist
sicentists	scientists
sicneice	science
sicsitnst	scientist
sieze	seize
signficantly	significantly
signficatly	significantly
signfitnt	significant
signianft	significant
signifacntly	significantly
signifance	significance
signifant	significant
signifcance	significance
signifcant	significant
signifcantly	significantly
signifcatly	significantly
signifiactly	significantly
signifianctly	significantly
signifiant	significant
signifiatn	significant
significanlt	significant
significatly	significantly
significnatly	significantly
signifnant	significant
signiticantly	significantly
signlal	signal
similair	similar
similarites	similarities
similarityes	similarities
similiar	similar
similuar	similar
simlair	similarly
simlar	similar
simliar	similar
simplificatoin	simplification
simplifing	simplifying
simulaneously	simultaneously
simulants	stimulants
simulatiously	simultaneously
simultaneiously	simultaneously
simultaniously	simultaneously
simultanously	simultaneously
simultatiousl	simultaneously
simultatiously	simultaneously
sincererly	sincerely
sincerly	sincerely
sinifcatly	significantly
sitiations	situations
situaion	situation
situatoin	situation
situtation	situation
situtations	situations
sitution	situation
slectively	selectively
sligtly	slightly
smothly	smoothly
socail	social
socciety	society
soceity	society
sociallism	socialism
socieatal	societal
socielly	socially
socilitzatoin	socialization
socilization	socialization
socilize	socialize
socitey	society
socities	societies
socity	society
soctiety	society
soical	social
soicalist	socialist
soicety	society
soiciety	society
solilique	soliloquy
soluitons	solutions
somehting	something
somemore	some more
somethig	something
somethign	something
someting	something
somewaht	somewhat
somthing	something
somtimes	sometimes
soocial	social
soothsasyer	soothsayer
sorce	source
sould	should
souldnt	shouldn't
spainish	Spanish
speaekr	speaker
specializatoin	specialization
specias	species
specifally	specially
specifc	specific
specifcally	specifically
specifiaclly	specifically
specifially	specifically
specifizatin	specification
speciic	specific
specualte	speculate
spedning	spending
speechs	speeches
spefic	specific
speicaliztion	specialization
speices	species
speicfic	specific
speicifally	specifically
speicific	specific
speicifically	specifically
speicilized	specialized
speific	specific
speiif	specific
speratic	sporadic
spontanoiusly	spontaneously
ssuccessful	successful
stablilty	stability
stablishmetn	establishment
stablity	stability
statemet	statement
statemetns	statements
statisfied	satisfied
statitics	statistics
statment	statement
statments	statements
steriods	steroids
steriotypes	stereotypes
steriotypicl	stereotypical
steriotypoing	stereotyping
stil	still
stinulus	stimulus
storgage	storage
strech	stretch
strenthened	strengthened
strucre	structure
structore	structure
structrue	structure
structual	structural
structues	structures
strucural	structural
strucure	structure
strucutre	structure
strucutred	structured
strucutres	structures
strugle	struggle
strugling	struggling
stucture	structure
studetns	students
studing	studying
studnet	student
studnets	students
studnt	student
stuructre	structure
subconcious	subconscious
subjecive	subjective
subjectivly	subjectively
subjexts	subjects
sublte	subtle
subsiquent	subsequent
subsiquently	subsequently
subsiquient	subsequent
substaintial	substantial
substative	substantive
substutiong	substituting
suburben	suburban
suc	such
succesful	successful
succesfull	successful
succesfully	successfully
succesion	succession
successul	successful
sucess	success
sucessful	successful
sufficent	sufficient
sugest	suggest
sugested	suggested
suggestsed	suggested
sujesting	suggesting
sujestions	suggestions
sumemrizing	summarizing
summerized	summarized
sunday	Sunday
supersturcte	superstructure
suply	supply
suported	supported
suppervision	supervision
supposidly	supposedly
suprisingly	surprisingly
surival	survival
surive	survive
surpase	surpass
surronding	surrounding
surviaval	survival
survie	survive
survivail	survival
survivial	survival
sutdents	students
swtich	switch
sybolism	symbolism
sying	saying
symantic	semantic
sympathiser	sympathizer
syntatic	syntactic
syphiliss	syphilis
systhesis	synthesis
sytem	system
sythesized	synthesized
tacktic	tactic
tacktics	tactics
tahn	than
taht	that
talbe	table
tangeble	tangible
tangiblie	tangible
tarribly	terribly
taugh	taught
teachre	teacher
teator	theater
techinques	techniques
techniuqes	techniques
technolgies	technologies
technuqes	techniques
technuque	technique
teh	the
tehen	then
tehy	they
tellnig	telling
temsleves	themselves
tendancies	tendencies
tendancy	tendency
tendnecy	tendency
tentionsion	tension
tentive	tentative
termially	terminally
termoil	turmoil
termonlogy	terminology
terriblly	terribly
testmant	testament
tey	they
thaan	than
theapeutic	therapeutic
theapist	therapist
theapy	therapy
thearapists	therapists
thearipy	therapy
theator	theater
theators	theaters
theeory	theory
themseles	themselves
theoaputic	therapeutic
theolgical	theological
theoogy	theology
theoratical	theoretical
theoretial	theoretical
theoripist	therapist
theoritic	theoretic
theoritical	theoretical
theorlogy	theology
theorm	theorem
theoropy	therapy
theortical	theoretical
theorum	theorem
theorys	theories
theprocess	the process
therfore	therefore
theroys	theories
thier	their
thiier	their
thoery	theory
thoguh	though
thories	theories
thoruhgt	throughout
thrid	third
throug	through
throughts	thoughts
ths	this
thse	these
thsi	this
thstablishmetn	establishment
tht	that
thta	that
thursday	Thursday
tihs	this
tobaco	tobacco
togehter	together
togheter	together
tohers	others
tollerance	tolerance
tomatoe	tomato
tommorow	tomorrow
tommorw	tomorrow
tothe	to the
tradtional	traditional
tradtions	traditions
tragety	tragedy
tragity	tragedy
traingle	triangle
traingles	triangles
tranformatoin	transformation
tranformed	transformed
trangle	triangle
transfered	transferred
transfermation	transformation
transitoin	transition
transiton	transition
transitoni	transition
translatoin	translation
transperant	transparent
transtion	transition
tremondous	tremendous
triagle	triangle
triagles	triangles
trivally	trivially
triynig	trying
trobbing	throbbing
truely	truly
trueth	truth
truimph	triumph
tryed	tried
tryied	tried
tryingto	trying to
tthat	that
tthe	the
tuesday	Tuesday
turmonal	turmoil
turmoul	turmoil
turtoring	tutoring
tvs	TVs
uanble	unable
ubt	but
ubtain	obtain
uderence	utterances
ultalmte	ultimate
ultametly	ultimately
ultamtly	ultimately
ultematly	ultimately
ultiamtly	ultimately
ultimatley	ultimately
ultimatly	ultimately
ultimetly	ultimately
ultiomate	ultimate
ultumate	ultimate
unabriged	unabridged
unaccetable	unacceptable
uncertantiy	uncertainty
uncertanty	uncertainty
uncertian	uncertain
uncesarly	unnecessarily
uncioncios	unconscious
uncoffortable	uncomfortable
uncommfortable	uncomfortable
unconcious	unconscious
unconciously	unconsciously
uncoperative	uncooperative
undermne	undermine
underpindings	underpinnings
underpinings	underpinnings
understad	understand
understadn	understand
understnad	understand
understnading	understanding
understnd	understand
understnding	understanding
understoon	understood
underswtanding	understanding
undertsnding	understanding
unecsarly	unnecessarily
unemployetm	unemployment
unescarly	unnecessarily
unesciarly	unnecessarily
uneseirly	unnecessarily
unesrcarly	unnecessarily
unforcdhatlay	unfortunately
unforchatly	unfortunately
unforchiatly	unfortunately
unforchinatly	unfortunately
unfortunatly	unfortunately
unhappyness	unhappiness
unimformed	uninformed
unintelligable	unintelligible
uniquness	uniqueness
univeral	universal
univerality	universality
univere	universe
universtiy	university
universty	university
univesal	universal
univesty	university
univiesty	university
univisties	universities
univisty	university
unknow	unknown
unnecciasrly	unnecessary
unnecesary	unnecessary
unnensirarly	unnecessarily
unnesiarly	unnecessarily
unnesicarly	unnecessarily
unnesirayl	unnecessarily
unnesisarly	unnecessarily
unnesisraly	unnecessarily
unnessicary	unnecessarily
unnnesiarly	unnecessarily
unofficail	unofficial
unoffical	unofficial
unorthedox	unorthodox
unprecidnented	unprecedented
unrepresantative	unrepresentative
untill	until
untimate	ultimate
unusally	unusually
unusaul	unusual
unviersal	universal
unviersally	universally
usefull	useful
usefullness	usefulness
useing	using
uterly	utterly
vacinate	vaccinate
vacum	vacuum
vacume	vacuum
vally	valley
valuminous	voluminous
varaible	variable
varialbe	variable
varialbes	variables
variaoin	variation
varibles	variables
varioables	variables
varous	various
varries	varies
varyious	various
vauge	vague
veiw	view
veloicty	velocity
vicarously	vicariously
victuems	victims
viens	veins
vigerously	vigorously
violnin	violin
visoin	vision
visously	viscously
visted	visited
vitial	vital
vlue	value
volcabularies	vocabularies
volme	volume
wahht	what
waht	what
warrent	warrant
wasnt	wasn't
watn	want
wavelenghts	wavelengths
wavelenth	wavelength
wcch	which
wednesday	Wednesday
wehn	when
wehre	where
Wendsday	Wednesday
werent	weren't
wether	whether
whateer	whatever
whcih	which
whenteh	when the
whic	which
whiich	which
whne	when
whre	where
whree	where
whta	what
wich	which
wierd	weird
wihich	which
wiht	with
wil	will
wilil	will
withte	with the
wommen	women
worknig	working
worthwile	worthwhile
writter	writer
writting	writing
writtings	writings
writtn	written
ws	was
wsa	was
wsas	was
wth	with
wtihout	without
wuold	would
youself	yourself
ystem	system
ythe	the
yuo	you
yuor	your
10-BaseT	10Base-T
10-baseT	10Base-T
10baseT	10Base-T
Applescript	AppleScript
BBedit	BBEdit
CD-Rom	CD-ROM
Earthlink	EarthLink
ethernet	Ethernet
Filemaker	FileMaker
Firewire	FireWire
FMPro	FileMaker Pro
FmPro	FileMaker Pro
Freehand	FreeHand
Gb	GB
Hypercard	HyperCard
i'd	I'd
i'm	I'm
i've	I've
internet	Internet
MacOS9	Mac OS 9
MacOS	 Mac OS
macos	Mac OS
MacOSX	Mac OS X
MacWorld	Macworld
Mb	MB
mbps	Mbps
Pagemaker	PageMaker
PhotoShop	Photoshop
Powerbook	PowerBook
powerbook	PowerBook
Powerbooks	PowerBooks
powerbooks	PowerBooks
powermac	Power Mac
QT	QuickTime
Quicktime	QuickTime
quicktime	QuickTime
THe	the
TIdBITS	TidBITS
TidBITs	TidBITS
TidBits	TidBITS
Tidbits	TidBITS
Tivo	TiVo
tivo	TiVo
website	Web site